,날짜,스크린수,스크린점유율,상영횟수,상영점유율,좌석수,좌석점유율,좌석판매율,매출액,매출액증감(전일대비),관객수,관객수증감(전일대비),누적매출액,누적관객수,순위
0,2019-05-30,1783,0.315,8262,0.462,1461863,0.529,0.389,4579290500,4519237500,568092,562494,4677727500,577954,1
1,2019-05-31,1826,0.326,8806,0.483,1553481,0.553,0.43,5893815975,1314525475,667826,99734,10571543475,1245780,1
2,2019-06-01,1927,0.332,9907,0.523,1734046,0.597,0.65,9909224473,4015408498,1126677,458851,20480767948,2372457,1
3,2019-06-02,1948,0.336,9820,0.531,1719057,0.604,0.579,8706733270,-1202491203,994607,-132070,29187501218,3367064,1
4,2019-06-03,1804,0.345,9196,0.528,1617395,0.599,0.236,3071603430,-5635129840,382497,-612110,32259104648,3749561,1
5,2019-06-04,1814,0.338,9193,0.528,1609901,0.596,0.217,2782574190,-289029240,348723,-33774,35041678838,4098284,1
6,2019-06-05,1700,0.298,8068,0.444,1383214,0.488,0.308,3435665860,653091670,425745,77022,38477344698,4524029,1
7,2019-06-06,1574,0.267,7975,0.41,1389997,0.462,0.598,7210821290,3775155430,831644,405899,45688165988,5355673,1
8,2019-06-07,1561,0.264,7877,0.408,1370051,0.459,0.379,4519273774,-2691547516,519720,-311924,50207439762,5875393,1
9,2019-06-08,1579,0.265,7958,0.405,1393383,0.458,0.458,5635004423,1115730649,637591,117871,55842444185,6512984,1
10,2019-06-09,1577,0.267,7736,0.406,1354680,0.458,0.376,4500961560,-1134042863,509134,-128457,60343405745,7022118,1
11,2019-06-10,1460,0.286,7287,0.418,1265901,0.468,0.154,1560319780,-2940641780,194662,-314472,61903725525,7216780,1
12,2019-06-11,1460,0.283,7251,0.418,1259143,0.467,0.125,1260270800,-300048980,157774,-36888,63163996325,7374554,1
13,2019-06-12,1217,0.243,5604,0.313,900847,0.322,0.162,1172366590,-87904210,146216,-11558,64336362915,7520770,1
14,2019-06-13,1170,0.216,5211,0.292,850549,0.306,0.16,1093021770,-79344820,136195,-10021,65429384685,7656965,1
15,2019-06-14,1194,0.214,5396,0.295,888113,0.312,0.189,1485706220,392684450,168192,31997,66915090905,7825157,1
16,2019-06-15,1206,0.199,5408,0.284,895258,0.306,0.312,2490643460,1004937240,279036,110844,69405734365,8104193,2
17,2019-06-16,1194,0.198,5297,0.282,884294,0.305,0.273,2175614880,-315028580,241608,-37428,71581349245,8345801,2
18,2019-06-17,1135,0.216,5240,0.301,868515,0.321,0.121,848174300,-1327440580,105206,-136402,72429523545,8451007,2
19,2019-06-18,1157,0.213,5214,0.301,861307,0.319,0.117,804249670,-43924630,100700,-4506,73233773215,8551707,2
20,2019-06-19,969,0.19,4159,0.234,639758,0.232,0.144,742575980,-61673690,92169,-8531,73976349195,8643876,3
21,2019-06-20,747,0.132,2780,0.148,406884,0.138,0.195,641665230,-100910750,79310,-12859,74618014425,8723186,4
22,2019-06-21,783,0.135,2872,0.15,411529,0.137,0.228,838396830,196731600,94020,14710,75456411255,8817206,4
23,2019-06-22,751,0.117,2451,0.122,330342,0.105,0.442,1304752130,466355300,145862,51842,76761163385,8963068,4
24,2019-06-23,769,0.119,2385,0.121,323871,0.106,0.411,1193849940,-110902190,133264,-12598,77955013325,9096332,4
25,2019-06-24,710,0.13,2682,0.146,364564,0.126,0.193,564327520,-629522420,70449,-62815,78519340845,9166781,3
26,2019-06-25,733,0.131,2691,0.146,366731,0.127,0.179,519563910,-44763610,65725,-4724,79038904755,9232506,3
27,2019-06-26,604,0.094,1441,0.077,187505,0.065,0.381,444699590,-74864320,71362,5637,79483604345,9303868,5
28,2019-06-27,569,0.094,1510,0.081,195937,0.068,0.237,365221300,-79478290,46497,-24865,79848825645,9350365,4
29,2019-06-28,614,0.1,1658,0.088,216942,0.074,0.232,440823590,75602290,50343,3846,80289649235,9400708,4
30,2019-06-29,642,0.095,1587,0.08,206890,0.068,0.439,809213330,368389740,90791,40448,81098862565,9491499,4
31,2019-06-30,650,0.097,1598,0.082,209232,0.07,0.413,763208620,-46004710,86482,-4309,81862071185,9577981,4
32,2019-07-01,625,0.094,1774,0.095,234989,0.081,0.172,324857040,-438351580,40512,-45970,82186928225,9618493,5
33,2019-07-02,446,0.076,912,0.049,107344,0.037,0.215,183117730,-141739310,23038,-17474,82370045955,9641531,4
34,2019-07-03,464,0.084,972,0.052,113935,0.04,0.196,178241150,-4876580,22294,-744,82548287105,9663825,4
35,2019-07-04,464,0.082,962,0.052,113923,0.04,0.194,176004620,-2236530,22078,-216,82724291725,9685903,4
36,2019-07-05,471,0.082,945,0.05,110977,0.038,0.223,218156710,42152090,24797,2719,82942448435,9710700,4
37,2019-07-06,410,0.07,762,0.039,87060,0.029,0.398,308185560,90028850,34674,9877,83250633995,9745374,4
38,2019-07-07,416,0.07,749,0.039,86291,0.029,0.352,268342490,-39843070,30407,-4267,83518976485,9775781,4
39,2019-07-08,476,0.087,1103,0.061,134050,0.048,0.171,169764490,-98578000,22941,-7466,83688740975,9798722,4
40,2019-07-09,488,0.086,1084,0.06,132854,0.047,0.175,172171870,2407380,23287,346,83860912845,9822009,4
41,2019-07-10,383,0.072,798,0.043,98083,0.034,0.185,130538910,-41632960,18103,-5184,83991451755,9840112,5
42,2019-07-11,357,0.06,640,0.034,81468,0.028,0.208,117862850,-12676060,16931,-1172,84109314605,9857043,5
43,2019-07-12,360,0.059,630,0.033,80009,0.027,0.214,129261750,11398900,17159,228,84238576355,9874202,5
44,2019-07-13,314,0.048,522,0.026,63563,0.021,0.382,198468390,69206640,24302,7143,84437044745,9898504,7
45,2019-07-14,315,0.049,528,0.027,65407,0.022,0.349,179004980,-19463410,22806,-1496,84616049725,9921310,7
46,2019-07-15,372,0.065,703,0.039,90417,0.033,0.162,100586800,-78418180,14650,-8156,84716636525,9935960,5
47,2019-07-16,374,0.063,712,0.04,92266,0.033,0.173,104922730,4335930,15950,1300,84821559255,9951910,5
48,2019-07-17,195,0.034,317,0.017,38545,0.013,0.205,50931020,-53991710,7886,-8064,84872490275,9959796,6
49,2019-07-18,196,0.033,305,0.016,38164,0.013,0.221,55429630,4498610,8446,560,84927919905,9968242,5
50,2019-07-19,192,0.032,308,0.016,39980,0.013,0.241,70737160,15307530,9641,1195,84998657065,9977883,5
51,2019-07-20,154,0.024,227,0.011,30215,0.01,0.389,90959090,20221930,11766,2125,85089616155,9989649,5
52,2019-07-21,170,0.026,243,0.012,30716,0.01,0.38,89627790,-1331300,11669,-97,85179243945,10001318,5
53,2019-07-22,205,0.036,372,0.02,45250,0.016,0.166,60945700,-28682090,7503,-4166,85240189645,10008821,5
54,2019-07-23,212,0.036,384,0.02,47210,0.016,0.184,69271400,8325700,8675,1172,85309461045,10017496,5
55,2019-07-24,78,0.014,118,0.006,15638,0.005,0.183,23193780,-46077620,2865,-5810,85332654825,10020361,10
56,2019-07-25,83,0.013,126,0.006,16039,0.005,0.212,27834380,4640600,3398,533,85360489205,10023759,10
57,2019-07-26,94,0.015,140,0.007,17758,0.006,0.218,35740260,7905880,3879,481,85396229465,10027638,9
58,2019-07-27,94,0.014,151,0.007,18996,0.006,0.362,62986240,27245980,6879,3000,85459215705,10034517,9
59,2019-07-28,99,0.014,160,0.008,20832,0.007,0.352,63485090,498850,7326,447,85522700795,10041843,9
60,2019-07-29,112,0.018,190,0.01,23857,0.008,0.216,42881570,-20603520,5161,-2165,85565582365,10047004,10
61,2019-07-30,111,0.017,188,0.01,23905,0.008,0.229,45215770,2334200,5478,317,85610798135,10052482,11
