,날짜,스크린수,스크린점유율,상영횟수,상영점유율,좌석수,좌석점유율,좌석판매율,매출액,매출액증감(전일대비),관객수,관객수증감(전일대비),누적매출액,누적관객수,순위
0,2012-07-25,890,0.264,4402,0.363,847704,0.401,0.515,3018752500,2989744500,436596,432970,3144987500,452445,1
1,2012-07-26,949,0.281,4553,0.373,887617,0.418,0.462,2855775000,-162977500,410169,-26427,6000762500,862614,1
2,2012-07-27,964,0.28,4849,0.382,942770,0.427,0.524,3605669500,749894500,493558,83389,9606432000,1356172,1
3,2012-07-28,1072,0.299,5369,0.405,1036359,0.449,0.733,5586991000,1981321500,759590,266032,15193423000,2115762,1
4,2012-07-29,1071,0.301,5279,0.408,1017282,0.452,0.738,5543976000,-43015000,750994,-8596,20737399000,2866756,1
5,2012-07-30,1001,0.287,5023,0.401,1001331,0.458,0.491,3456004000,-2087972000,492035,-258959,24193403000,3358791,1
6,2012-07-31,1013,0.286,5007,0.398,999256,0.456,0.5,3478524500,22520500,499297,7262,27671927500,3858088,1
7,2012-08-01,1025,0.281,5041,0.389,1032853,0.458,0.491,3553332500,74808000,506630,7333,31225260000,4364718,1
8,2012-08-02,992,0.269,4987,0.379,1036301,0.453,0.492,3588891500,35559000,509864,3234,34814151500,4874582,1
9,2012-08-03,1020,0.268,5154,0.384,1066042,0.457,0.523,4129366000,540474500,557151,47287,38943517500,5431733,1
10,2012-08-04,1091,0.268,5475,0.398,1121613,0.47,0.687,5740985500,1611619500,770715,213564,44684503000,6202448,1
11,2012-08-05,1090,0.27,5369,0.4,1100648,0.471,0.619,5099267500,-641718000,681369,-89346,49783770500,6883817,1
12,2012-08-06,1041,0.274,5025,0.39,1039249,0.463,0.373,2729707500,-2369560000,387944,-293425,52513478000,7271761,1
13,2012-08-07,1040,0.273,5005,0.389,1035048,0.462,0.314,2267838500,-461869000,324899,-63045,54781316500,7596660,1
14,2012-08-08,747,0.212,3664,0.279,764474,0.332,0.336,1803625500,-464213000,256714,-68185,56584942000,7853374,1
15,2012-08-09,753,0.211,3709,0.281,776012,0.335,0.316,1717669500,-85956000,245469,-11245,58302611500,8098843,1
16,2012-08-10,788,0.215,3800,0.283,790634,0.336,0.348,2032827000,315157500,275092,29623,60335438500,8373935,1
17,2012-08-11,794,0.204,4005,0.286,829121,0.339,0.544,3380163000,1347336000,451292,176200,63715601500,8825227,1
18,2012-08-12,800,0.206,3881,0.283,802038,0.334,0.514,3065532000,-314631000,412133,-39159,66781133500,9237360,1
19,2012-08-13,739,0.21,3608,0.278,743492,0.327,0.325,1696220500,-1369311500,241324,-170809,68477354000,9478684,1
20,2012-08-14,714,0.182,3382,0.252,688093,0.293,0.407,1944350000,248129500,279939,38615,70421704000,9758623,1
21,2012-08-15,552,0.154,2461,0.175,458630,0.187,0.735,2472606000,528256000,337187,57248,72894310000,10095810,2
22,2012-08-16,532,0.153,2421,0.179,453954,0.191,0.433,1367876500,-1104729500,196457,-140730,74262186500,10292267,1
23,2012-08-17,551,0.155,2533,0.182,477013,0.196,0.435,1521955000,154078500,207728,11271,75784141500,10499995,1
24,2012-08-18,621,0.166,2746,0.19,526154,0.208,0.635,2463886000,941931000,334138,126410,78248027500,10834133,2
25,2012-08-19,618,0.168,2679,0.191,513663,0.209,0.571,2165431500,-298454500,293345,-40793,80413459000,11127478,2
26,2012-08-20,578,0.169,2533,0.192,497982,0.216,0.253,878743500,-1286688000,125863,-167482,81292202500,11253341,1
27,2012-08-21,580,0.168,2521,0.193,495363,0.217,0.245,839214500,-39529000,121300,-4563,82131417000,11374641,1
28,2012-08-22,525,0.157,2316,0.176,463585,0.201,0.23,737564500,-101650000,106799,-14501,82868981500,11481440,2
29,2012-08-23,498,0.146,2203,0.168,447490,0.194,0.223,684149000,-53415500,99712,-7087,83553130500,11581152,2
30,2012-08-24,508,0.147,2301,0.17,470749,0.199,0.239,816454000,132305000,112740,13028,84369584500,11693892,2
31,2012-08-25,544,0.147,2425,0.17,492786,0.198,0.436,1596443500,779989500,215021,102281,85966028000,11908913,3
32,2012-08-26,540,0.148,2321,0.169,469544,0.195,0.396,1373591500,-222852000,186010,-29011,87339619500,12094923,3
33,2012-08-27,502,0.154,2140,0.173,427988,0.196,0.154,450191000,-923400500,65787,-120223,87789810500,12160710,2
34,2012-08-28,496,0.15,2114,0.172,422292,0.194,0.126,382285000,-67906000,53398,-12389,88172095500,12214108,2
35,2012-08-29,423,0.133,1875,0.147,359085,0.159,0.158,388422500,6137500,56866,3468,88560518000,12270974,3
36,2012-08-30,351,0.109,1515,0.114,269800,0.115,0.204,372041000,-16381500,55051,-1815,88932559000,12326025,3
37,2012-08-31,358,0.109,1572,0.114,279327,0.115,0.231,462222500,90181500,64661,9610,89394781500,12390686,3
38,2012-09-01,362,0.102,1640,0.113,290180,0.114,0.37,808890000,346667500,107379,42718,90203671500,12498065,4
39,2012-09-02,365,0.104,1573,0.113,278261,0.114,0.336,694433000,-114457000,93359,-14020,90898104500,12591424,4
40,2012-09-03,353,0.114,1498,0.119,263348,0.118,0.119,215150000,-479283000,31364,-61995,91113254500,12622788,3
41,2012-09-04,364,0.116,1506,0.12,264906,0.119,0.129,229903000,14753000,34114,2750,91343157500,12656902,3
42,2012-09-05,359,0.113,1490,0.118,264613,0.119,0.111,199981500,-29921500,29470,-4644,91543139000,12686372,3
43,2012-09-06,307,0.094,1029,0.082,156121,0.07,0.137,143769500,-56212000,21381,-8089,91686908500,12707753,5
44,2012-09-07,312,0.093,1061,0.081,159602,0.069,0.163,186078500,42309000,25952,4571,91872987000,12733705,5
45,2012-09-08,323,0.09,1138,0.082,169613,0.07,0.322,409649000,223570500,54578,28626,92282636000,12788283,6
46,2012-09-09,320,0.091,1082,0.081,161984,0.069,0.3,360582000,-49067000,48661,-5917,92643218000,12836944,6
47,2012-09-10,300,0.091,1021,0.082,154939,0.071,0.108,111879000,-248703000,16722,-31939,92755097000,12853666,6
48,2012-09-11,297,0.09,1000,0.082,152107,0.071,0.104,104875000,-7004000,15772,-950,92859972000,12869438,6
49,2012-09-12,302,0.091,994,0.082,150050,0.07,0.102,103561500,-1313500,15369,-403,92963533500,12884807,6
50,2012-09-13,185,0.054,411,0.033,54094,0.025,0.123,44875000,-58686500,6637,-8732,93008408500,12891444,8
51,2012-09-14,187,0.053,408,0.031,53312,0.023,0.137,51806000,6931000,7297,660,93060214500,12898741,9
52,2012-09-15,194,0.05,419,0.03,54385,0.022,0.237,96624500,44818500,12887,5590,93156839000,12911628,9
53,2012-09-16,194,0.052,403,0.03,52122,0.022,0.228,88809500,-7815000,11871,-1016,93245648500,12923499,9
54,2012-09-17,181,0.054,375,0.031,49759,0.023,0.096,33329500,-55480000,4774,-7097,93278978000,12928273,9
55,2012-09-18,177,0.052,382,0.031,50518,0.023,0.083,28277500,-5052000,4216,-558,93307255500,12932489,9
56,2012-09-19,178,0.052,383,0.032,50815,0.024,0.078,26911000,-1366500,3977,-239,93334166500,12936466,9
57,2012-09-20,83,0.025,129,0.011,16011,0.008,0.087,9447000,-17464000,1386,-2591,93343613500,12937852,11
58,2012-09-21,86,0.025,136,0.011,16944,0.008,0.096,12003000,2556000,1619,233,93355616500,12939471,11
59,2012-09-22,72,0.019,130,0.01,15875,0.007,0.179,21647500,9644500,2843,1224,93377264000,12942314,9
60,2012-09-23,75,0.02,125,0.01,15524,0.007,0.161,18939500,-2708000,2507,-336,93396203500,12944821,9
61,2012-09-24,86,0.026,144,0.012,17552,0.008,0.066,7798500,-11141000,1156,-1351,93404002000,12945977,11
62,2012-09-25,86,0.026,145,0.012,17596,0.008,0.073,8666000,867500,1279,123,93412668000,12947256,11
63,2012-09-26,84,0.025,145,0.012,17751,0.009,0.071,8542500,-123500,1266,-13,93421210500,12948522,11
64,2012-09-27,63,0.02,116,0.009,15090,0.007,0.06,6031500,-2511000,908,-358,93427242000,12949430,13
65,2012-09-28,63,0.019,124,0.009,16637,0.007,0.096,11385500,5354000,1597,689,93438627500,12951027,10
66,2012-09-29,74,0.02,147,0.01,17744,0.007,0.191,24677000,13291500,3384,1787,93463304500,12954411,10
67,2012-09-30,75,0.02,148,0.01,17777,0.007,0.328,43610500,18933500,5839,2455,93506915000,12960250,9
68,2012-10-01,76,0.02,145,0.01,17725,0.007,0.426,54951000,11340500,7556,1717,93561866000,12967806,10
69,2012-10-02,74,0.019,139,0.01,16665,0.007,0.334,37952000,-16999000,5571,-1985,93599818000,12973377,10
